  P    ATAR  ATA      ATAATA
  AMR   A     A R      A  A 
 ATA P                 R U  
  A                         
     U    U   A             
      A U    ATAR  U R      
     ATA     RA             
 U A  A      U           A  
 AATA  R   R      A     ATA 
ATAU   U  U R    ATA R   A  
 A    A     A A R A         
     ATA   ATATA   U   T  T 
      AR  ATA A A    R   T  
 U      U  A R ATA     T    
               RA        R  
        R    U       BTT    
R         R N   R           
               U     R      
  U                      A U
    R R A               ATA 
       ATA             A A  
        A          A AATA U 
 U    R           ATATAA    
                   A A      
  UU    RA                  
        ATA    A U          
         A    ATA           
U         A    AR     A     
 U       ATA     UU  ATA    
          A           A  R  
